






           *
           *
           *
           ******
                *
                *
                *
       *******************************
       *
       *
       *************
       *        *
       *        *
       *          *
       *        *
                *
